**********
*P       *
*        *
*  *     *
*  *  M  *
*       **
*        *
*        *
*      *G*
**********
